####################
#....#....#.....#..#
#.#.###.#.#.#.###..#
#.#.#.....#.#.....##
#.#.#######.####.#.#
#.#.#.........#...##
#.#.#.###.###.###..#
#.#.....#...#.....##
#.#.#####.#.#.###.#.
#.#.#.....#.#.....##
#.#.#.#.#.#.#.###.#.
#.#.#.#.#.#.#.....##
#...#.#...#.#.#####.
#.###.#.#.#.#.....##
#.#.....#...#.###..#
#.#.#.#######.....##
#.#.#........#.###.#
#.#.########.#.....#
#...##.......#.....#
####################
